####  #################################
#                                     #
#                                     #
#                    ############ #####
#                                     #
#                                 #####
#            #                        #
#            #                        #
#            #                        #
#            #                        #
#            #                        #
#            #                  #######
#                                     #
################################ ######
#            #                        #
#            #                        #
#            #                        #
#            #                        #
#            #                        #
#            #                        #
#                                     #
#                                     #
#                                     #
#                                     #
#                                     #
#                                     #
################################  #####
